1111111111111
10010CCC0CCC1
1000011111001
10P001100E0C1
1111111111111