111111
1E0C01
100001
1P0001
111111